************
* * * * * **
*  *  *  * *
*   *   *  *
*    *    **
*     *    *
*      *   *
*       *  *
*        * *
*         **
*          *
************